"Region","year","RptArea","rfharv","pelagic_harv","nonpel_harv","ye_harv","not_ye_nonpel_harv"
"SC",1998,"AFOGNAK",416,329,87,NA,NA
"SC",1998,"ALEUTIAN",214,89,125,NA,NA
"SC",1998,"BERING",0,0,0,0,0
"SC",1998,"BSAI",214,89,125,NA,NA
"SC",1998,"CHIGNIK",1,0,1,NA,NA
"SC",1998,"CI",994,723,271,NA,NA
"SE",1998,"CSEO",9366,4464,4902,NA,NA
"SC",1998,"EASTSIDE",157,75,82,NA,NA
"SE",1998,"EWYKT",1305,699,606,NA,NA
"SE",1998,"EYKT",311,209,102,NA,NA
"SE",1998,"IBS",994,490,504,NA,NA
"SC",1998,"MAINLAND",6,5,1,NA,NA
"SC",1998,"NG",5169,3927,1242,NA,NA
"SC",1998,"NORTHEAST",1488,977,511,NA,NA
"SE",1998,"NSEI",5285,2544,2741,NA,NA
"SE",1998,"NSEO",1123,601,522,NA,NA
"SC",1998,"PWSI",3821,2098,1723,NA,NA
"SC",1998,"PWSO",7091,5439,1652,NA,NA
"SC",1998,"SAKPEN",0,0,0,0,0
"SC",1998,"SKMA",27,22,5,NA,NA
"SC",1998,"SOKO2SAP",28,22,6,NA,NA
"SC",1998,"SOUTHEAST",0,0,0,0,0
"SC",1998,"SOUTHWEST",27,22,5,NA,NA
"SE",1998,"SSEI",6261,2769,3492,NA,NA
"SE",1998,"SSEO",3185,1462,1723,NA,NA
"SC",1998,"WESTSIDE",142,112,30,NA,NA
"SC",1998,"WKMA",148,117,31,NA,NA
"SC",1999,"AFOGNAK",506,419,87,NA,NA
"SC",1999,"ALEUTIAN",45,13,32,NA,NA
"SC",1999,"BERING",0,0,0,0,0
"SC",1999,"BSAI",45,13,32,NA,NA
"SC",1999,"CHIGNIK",0,0,0,0,0
"SC",1999,"CI",911,809,102,NA,NA
"SE",1999,"CSEO",9636,3836,5800,NA,NA
"SC",1999,"EASTSIDE",121,100,21,NA,NA
"SE",1999,"EWYKT",663,547,116,NA,NA
"SE",1999,"EYKT",27,22,5,NA,NA
"SE",1999,"IBS",636,525,111,NA,NA
"SC",1999,"MAINLAND",4,4,0,0,0
"SC",1999,"NG",9276,8138,1138,NA,NA
"SC",1999,"NORTHEAST",1866,1689,177,NA,NA
"SE",1999,"NSEI",6363,3857,2506,NA,NA
"SE",1999,"NSEO",1071,484,587,NA,NA
"SC",1999,"PWSI",4514,2609,1905,NA,NA
"SC",1999,"PWSO",4594,3253,1341,NA,NA
"SC",1999,"SAKPEN",0,0,0,0,0
"SC",1999,"SKMA",88,73,15,NA,NA
"SC",1999,"SOKO2SAP",88,73,15,NA,NA
"SC",1999,"SOUTHEAST",88,73,15,NA,NA
"SC",1999,"SOUTHWEST",0,0,0,0,0
"SE",1999,"SSEI",7370,3832,3538,NA,NA
"SE",1999,"SSEO",4616,1568,3048,NA,NA
"SC",1999,"WESTSIDE",224,219,5,NA,NA
"SC",1999,"WKMA",228,223,5,NA,NA
"SC",2000,"AFOGNAK",1412,1224,188,NA,NA
"SC",2000,"ALEUTIAN",61,59,2,NA,NA
"SC",2000,"BERING",0,0,0,0,0
"SC",2000,"BSAI",61,59,2,NA,NA
"SC",2000,"CHIGNIK",0,0,0,0,0
"SC",2000,"CI",1400,1225,175,NA,NA
"SE",2000,"CSEO",16855,5777,11078,NA,NA
"SC",2000,"EASTSIDE",423,380,43,NA,NA
"SE",2000,"EWYKT",1199,1057,142,NA,NA
"SE",2000,"EYKT",61,54,7,NA,NA
"SE",2000,"IBS",1138,1003,135,NA,NA
"SC",2000,"MAINLAND",26,26,0,0,0
"SC",2000,"NG",13107,10703,2404,NA,NA
"SC",2000,"NORTHEAST",2115,1865,250,NA,NA
"SE",2000,"NSEI",9746,5582,4164,NA,NA
"SE",2000,"NSEO",2883,1457,1426,NA,NA
"SC",2000,"PWSI",6011,3391,2620,NA,NA
"SC",2000,"PWSO",9244,7038,2206,NA,NA
"SC",2000,"SAKPEN",0,0,0,0,0
"SC",2000,"SKMA",65,5,60,NA,NA
"SC",2000,"SOKO2SAP",65,5,60,NA,NA
"SC",2000,"SOUTHEAST",62,2,60,NA,NA
"SC",2000,"SOUTHWEST",3,3,0,0,0
"SE",2000,"SSEI",11989,5112,6877,NA,NA
"SE",2000,"SSEO",6910,2150,4760,NA,NA
"SC",2000,"WESTSIDE",360,282,78,NA,NA
"SC",2000,"WKMA",386,308,78,NA,NA
"SC",2001,"AFOGNAK",535,477,58,NA,NA
"SC",2001,"ALEUTIAN",67,47,20,NA,NA
"SC",2001,"BERING",0,0,0,0,0
"SC",2001,"BSAI",67,47,20,NA,NA
"SC",2001,"CHIGNIK",0,0,0,0,0
"SC",2001,"CI",763,694,69,NA,NA
"SE",2001,"CSEO",15083,4037,11046,NA,NA
"SC",2001,"EASTSIDE",298,231,67,NA,NA
"SE",2001,"EWYKT",1043,891,152,NA,NA
"SE",2001,"EYKT",72,57,15,NA,NA
"SE",2001,"IBS",971,834,137,NA,NA
"SC",2001,"MAINLAND",1,1,0,0,0
"SC",2001,"NG",20907,18457,2450,NA,NA
"SC",2001,"NORTHEAST",2081,1854,227,NA,NA
"SE",2001,"NSEI",7242,3909,3333,NA,NA
"SE",2001,"NSEO",2839,1235,1604,NA,NA
"SC",2001,"PWSI",7036,4209,2827,NA,NA
"SC",2001,"PWSO",11235,8211,3024,NA,NA
"SC",2001,"SAKPEN",0,0,0,0,0
"SC",2001,"SKMA",27,8,19,NA,NA
"SC",2001,"SOKO2SAP",27,8,19,NA,NA
"SC",2001,"SOUTHEAST",27,8,19,NA,NA
"SC",2001,"SOUTHWEST",0,0,0,0,0
"SE",2001,"SSEI",9348,4514,4834,NA,NA
"SE",2001,"SSEO",5756,1879,3877,NA,NA
"SC",2001,"WESTSIDE",1181,1157,24,NA,NA
"SC",2001,"WKMA",1182,1158,24,NA,NA
"SC",2002,"AFOGNAK",345,291,54,NA,NA
"SC",2002,"ALEUTIAN",112,100,12,NA,NA
"SC",2002,"BERING",1,1,0,0,0
"SC",2002,"BSAI",113,101,12,NA,NA
"SC",2002,"CHIGNIK",0,0,0,0,0
"SC",2002,"CI",2378,2107,271,NA,NA
"SE",2002,"CSEO",14004,5206,8798,NA,NA
"SC",2002,"EASTSIDE",319,269,50,NA,NA
"SE",2002,"EWYKT",893,791,102,NA,NA
"SE",2002,"EYKT",9,9,0,NA,NA
"SE",2002,"IBS",884,782,102,NA,NA
"SC",2002,"MAINLAND",15,15,0,0,0
"SC",2002,"NG",17318,15088,2230,NA,NA
"SC",2002,"NORTHEAST",2262,2052,210,NA,NA
"SE",2002,"NSEI",4958,3120,1838,NA,NA
"SE",2002,"NSEO",2029,687,1342,NA,NA
"SC",2002,"PWSI",7398,4880,2518,NA,NA
"SC",2002,"PWSO",9018,6632,2386,NA,NA
"SC",2002,"SAKPEN",105,105,0,0,0
"SC",2002,"SKMA",99,88,11,NA,NA
"SC",2002,"SOKO2SAP",204,193,11,NA,NA
"SC",2002,"SOUTHEAST",98,87,11,NA,NA
"SC",2002,"SOUTHWEST",1,1,0,0,0
"SE",2002,"SSEI",8033,3969,4064,NA,NA
"SE",2002,"SSEO",7617,3492,4125,NA,NA
"SC",2002,"WESTSIDE",865,796,69,NA,NA
"SC",2002,"WKMA",880,811,69,NA,NA
"SC",2003,"AFOGNAK",567,484,83,NA,NA
"SC",2003,"ALEUTIAN",178,178,0,0,0
"SC",2003,"BERING",0,0,0,0,0
"SC",2003,"BSAI",178,178,0,0,0
"SC",2003,"CHIGNIK",0,0,0,0,0
"SC",2003,"CI",4623,4247,376,NA,NA
"SE",2003,"CSEO",15272,6711,8561,NA,NA
"SC",2003,"EASTSIDE",1012,964,48,NA,NA
"SE",2003,"EWYKT",1627,1184,443,NA,NA
"SE",2003,"EYKT",169,84,85,NA,NA
"SE",2003,"IBS",1458,1100,358,NA,NA
"SC",2003,"MAINLAND",11,11,0,0,0
"SC",2003,"NG",17020,13573,3447,NA,NA
"SC",2003,"NORTHEAST",2743,2477,266,NA,NA
"SE",2003,"NSEI",6069,3551,2518,NA,NA
"SE",2003,"NSEO",3083,1424,1659,NA,NA
"SC",2003,"PWSI",11932,8745,3187,NA,NA
"SC",2003,"PWSO",9696,7248,2448,NA,NA
"SC",2003,"SAKPEN",0,0,0,0,0
"SC",2003,"SKMA",144,104,40,NA,NA
"SC",2003,"SOKO2SAP",144,104,40,NA,NA
"SC",2003,"SOUTHEAST",138,98,40,NA,NA
"SC",2003,"SOUTHWEST",6,6,0,0,0
"SE",2003,"SSEI",11263,5648,5615,NA,NA
"SE",2003,"SSEO",6896,2806,4090,NA,NA
"SC",2003,"WESTSIDE",1096,947,149,NA,NA
"SC",2003,"WKMA",1107,958,149,NA,NA
"SC",2004,"AFOGNAK",468,338,130,NA,NA
"SC",2004,"ALEUTIAN",51,40,11,NA,NA
"SC",2004,"BERING",0,0,0,0,0
"SC",2004,"BSAI",51,40,11,NA,NA
"SC",2004,"CHIGNIK",29,23,6,NA,NA
"SC",2004,"CI",4736,4470,266,NA,NA
"SE",2004,"CSEO",21796,9789,12007,NA,NA
"SC",2004,"EASTSIDE",730,672,58,NA,NA
"SE",2004,"EWYKT",1501,1123,378,NA,NA
"SE",2004,"EYKT",66,27,39,NA,NA
"SE",2004,"IBS",1435,1096,339,NA,NA
"SC",2004,"MAINLAND",8,5,3,NA,NA
"SC",2004,"NG",19434,15959,3475,NA,NA
"SC",2004,"NORTHEAST",3291,3068,223,NA,NA
"SE",2004,"NSEI",6052,3328,2724,NA,NA
"SE",2004,"NSEO",2923,999,1924,NA,NA
"SC",2004,"PWSI",10310,7438,2872,NA,NA
"SC",2004,"PWSO",12216,9240,2976,NA,NA
"SC",2004,"SAKPEN",0,0,0,0,0
"SC",2004,"SKMA",200,159,41,NA,NA
"SC",2004,"SOKO2SAP",229,182,47,NA,NA
"SC",2004,"SOUTHEAST",197,157,40,NA,NA
"SC",2004,"SOUTHWEST",3,2,1,NA,NA
"SE",2004,"SSEI",13195,5266,7929,NA,NA
"SE",2004,"SSEO",10061,4143,5918,NA,NA
"SC",2004,"WESTSIDE",802,711,91,NA,NA
"SC",2004,"WKMA",810,716,94,NA,NA
"SC",2005,"AFOGNAK",1385,1179,206,NA,NA
"SC",2005,"ALEUTIAN",34,32,2,NA,NA
"SC",2005,"BERING",0,0,0,0,0
"SC",2005,"BSAI",34,32,2,NA,NA
"SC",2005,"CHIGNIK",61,61,0,NA,NA
"SC",2005,"CI",3615,3460,155,NA,NA
"SE",2005,"CSEO",27304,12886,14418,NA,NA
"SC",2005,"EASTSIDE",1242,1074,168,NA,NA
"SE",2005,"EWYKT",1676,1392,284,NA,NA
"SE",2005,"EYKT",47,6,41,NA,NA
"SE",2005,"IBS",1629,1386,243,NA,NA
"SC",2005,"MAINLAND",31,31,0,0,0
"SC",2005,"NG",22792,18621,4171,NA,NA
"SC",2005,"NORTHEAST",4641,4325,316,NA,NA
"SE",2005,"NSEI",7678,4465,3213,NA,NA
"SE",2005,"NSEO",2796,1188,1608,NA,NA
"SC",2005,"PWSI",10930,8176,2754,NA,NA
"SC",2005,"PWSO",9664,7477,2177,NA,NA
"SC",2005,"SAKPEN",14,2,12,NA,NA
"SC",2005,"SKMA",287,128,159,NA,NA
"SC",2005,"SOKO2SAP",362,191,171,NA,NA
"SC",2005,"SOUTHEAST",287,128,159,NA,NA
"SC",2005,"SOUTHWEST",0,0,0,0,0
"SE",2005,"SSEI",15329,5745,9584,NA,NA
"SE",2005,"SSEO",12666,5423,7243,NA,NA
"SC",2005,"WESTSIDE",1235,1102,133,NA,NA
"SC",2005,"WKMA",1266,1133,133,NA,NA
"SC",2006,"AFOGNAK",925,766,159,133,26
"SC",2006,"ALEUTIAN",8,3,5,5,0
"SC",2006,"BERING",0,0,0,0,0
"SC",2006,"BSAI",8,3,5,5,0
"SC",2006,"CHIGNIK",68,66,2,0,2
"SC",2006,"CI",2463,2250,213,98,115
"SE",2006,"CSEO",33748,20139,13609,9779,3830
"SC",2006,"EASTSIDE",1516,1356,160,122,38
"SE",2006,"EWYKT",2529,2089,440,167,273
"SE",2006,"EYKT",272,182,90,42,48
"SE",2006,"IBS",2257,1907,350,125,225
"SC",2006,"MAINLAND",15,15,0,0,0
"SC",2006,"NG",19998,15867,4131,2876,1255
"SC",2006,"NORTHEAST",3693,3519,174,96,78
"SE",2006,"NSEI",6437,3476,2961,1422,1539
"SE",2006,"NSEO",3058,1407,1651,931,720
"SC",2006,"PWSI",7578,4593,2985,1907,1078
"SC",2006,"PWSO",9129,6195,2934,2437,497
"SC",2006,"SAKPEN",16,7,9,9,0
"SC",2006,"SKMA",303,191,112,69,43
"SC",2006,"SOKO2SAP",387,264,123,78,45
"SC",2006,"SOUTHEAST",303,191,112,69,43
"SC",2006,"SOUTHWEST",0,0,0,0,0
"SE",2006,"SSEI",17714,6326,11388,4211,7177
"SE",2006,"SSEO",12007,4774,7233,4257,2976
"SC",2006,"WESTSIDE",722,567,155,118,37
"SC",2006,"WKMA",737,582,155,118,37
"SC",2007,"AFOGNAK",2488,2184,304,217,87
"SC",2007,"ALEUTIAN",27,16,11,7,4
"SC",2007,"BERING",0,0,0,0,0
"SC",2007,"BSAI",27,16,11,7,4
"SC",2007,"CHIGNIK",154,154,0,0,0
"SC",2007,"CI",2559,2365,194,94,100
"SE",2007,"CSEO",38443,24055,14388,9950,4438
"SC",2007,"EASTSIDE",3481,3310,171,108,63
"SE",2007,"EWYKT",2290,1956,334,108,226
"SE",2007,"EYKT",242,146,96,51,45
"SE",2007,"IBS",2048,1810,238,57,181
"SC",2007,"MAINLAND",31,15,16,16,0
"SC",2007,"NG",23861,19743,4118,2978,1140
"SC",2007,"NORTHEAST",5080,4652,428,156,272
"SE",2007,"NSEI",7499,4164,3335,1191,2144
"SE",2007,"NSEO",4266,2518,1748,1014,734
"SC",2007,"PWSI",12404,9289,3115,1944,1171
"SC",2007,"PWSO",12198,8339,3859,3287,572
"SC",2007,"SAKPEN",0,0,0,0,0
"SC",2007,"SKMA",1148,969,179,157,22
"SC",2007,"SOKO2SAP",1302,1123,179,157,22
"SC",2007,"SOUTHEAST",1148,969,179,157,22
"SC",2007,"SOUTHWEST",0,0,0,0,0
"SE",2007,"SSEI",20368,8353,12015,3637,8378
"SE",2007,"SSEO",12018,5924,6094,3554,2540
"SC",2007,"WESTSIDE",1614,1293,321,226,95
"SC",2007,"WKMA",1645,1308,337,242,95
"SC",2008,"AFOGNAK",2670,2069,601,509,92
"SC",2008,"ALEUTIAN",25,17,8,8,0
"SC",2008,"BERING",0,0,0,0,0
"SC",2008,"BSAI",25,17,8,8,0
"SC",2008,"CHIGNIK",113,113,0,0,0
"SC",2008,"CI",2163,2006,157,96,61
"SE",2008,"CSEO",52901,37625,15276,8863,6413
"SC",2008,"EASTSIDE",2311,2098,213,140,73
"SE",2008,"EWYKT",2857,2456,401,161,240
"SE",2008,"EYKT",309,177,132,56,76
"SE",2008,"IBS",2548,2279,269,105,164
"SC",2008,"MAINLAND",10,1,9,7,2
"SC",2008,"NG",25596,20867,4729,3376,1353
"SC",2008,"NORTHEAST",6260,5853,407,268,139
"SE",2008,"NSEI",10923,6828,4095,1308,2787
"SE",2008,"NSEO",5010,3047,1963,1009,954
"SC",2008,"PWSI",9522,6899,2623,1495,1128
"SC",2008,"PWSO",13387,9818,3569,2906,663
"SC",2008,"SAKPEN",0,0,0,0,0
"SC",2008,"SKMA",1130,1042,88,59,29
"SC",2008,"SOKO2SAP",1243,1155,88,59,29
"SC",2008,"SOUTHEAST",1130,1042,88,59,29
"SC",2008,"SOUTHWEST",0,0,0,0,0
"SE",2008,"SSEI",18756,8206,10550,3569,6981
"SE",2008,"SSEO",17754,10801,6953,3418,3535
"SC",2008,"WESTSIDE",1186,899,287,204,83
"SC",2008,"WKMA",1196,900,296,211,85
"SC",2009,"AFOGNAK",3763,3206,557,466,91
"SC",2009,"ALEUTIAN",0,0,0,0,0
"SC",2009,"BERING",0,0,0,0,0
"SC",2009,"BSAI",0,0,0,0,0
"SC",2009,"CHIGNIK",4,4,0,0,0
"SC",2009,"CI",2918,2662,256,142,114
"SE",2009,"CSEO",31717,22290,9427,6423,3004
"SC",2009,"EASTSIDE",2296,2247,49,30,19
"SE",2009,"EWYKT",2494,2193,301,79,222
"SE",2009,"EYKT",476,377,99,39,60
"SE",2009,"IBS",2018,1816,202,40,162
"SC",2009,"MAINLAND",3,1,2,2,0
"SC",2009,"NG",21909,18588,3321,2548,773
"SC",2009,"NORTHEAST",6369,6087,282,190,92
"SE",2009,"NSEI",9325,5994,3331,955,2376
"SE",2009,"NSEO",2818,1954,864,580,284
"SC",2009,"PWSI",8197,5973,2224,1306,918
"SC",2009,"PWSO",13724,10348,3376,2889,487
"SC",2009,"SAKPEN",38,22,16,0,16
"SC",2009,"SKMA",810,721,89,76,13
"SC",2009,"SOKO2SAP",852,747,105,76,29
"SC",2009,"SOUTHEAST",775,686,89,76,13
"SC",2009,"SOUTHWEST",35,35,0,0,0
"SE",2009,"SSEI",14837,6518,8319,2902,5417
"SE",2009,"SSEO",9645,5953,3692,1788,1904
"SC",2009,"WESTSIDE",1846,1516,330,247,83
"SC",2009,"WKMA",1849,1517,332,249,83
"SC",2010,"AFOGNAK",3032,1971,1061,348,713
"SC",2010,"ALEUTIAN",54,54,0,0,0
"SC",2010,"BERING",0,0,0,0,0
"SC",2010,"BSAI",54,54,0,0,0
"SC",2010,"CHIGNIK",105,47,58,0,58
"SC",2010,"CI",4422,3249,1173,185,988
"SE",2010,"CSEO",43813,30785,13028,7150,5878
"SC",2010,"EASTSIDE",2555,1663,892,74,818
"SE",2010,"EWYKT",2435,1932,503,119,384
"SE",2010,"EYKT",133,48,85,23,62
"SE",2010,"IBS",2302,1884,418,96,322
"SC",2010,"MAINLAND",11,3,8,8,0
"SC",2010,"NG",27027,20838,6189,3449,2740
"SC",2010,"NORTHEAST",8141,6708,1433,288,1145
"SE",2010,"NSEI",11942,7473,4469,1377,3092
"SE",2010,"NSEO",4613,2971,1642,737,905
"SC",2010,"PWSI",11909,8081,3828,1880,1948
"SC",2010,"PWSO",13038,8515,4523,3537,986
"SC",2010,"SAKPEN",0,0,0,0,0
"SC",2010,"SKMA",644,400,244,80,164
"SC",2010,"SOKO2SAP",749,447,302,80,222
"SC",2010,"SOUTHEAST",644,400,244,80,164
"SC",2010,"SOUTHWEST",0,0,0,0,0
"SE",2010,"SSEI",20015,8957,11058,3159,7899
"SE",2010,"SSEO",12415,7422,4993,2393,2600
"SC",2010,"WESTSIDE",1255,790,465,309,156
"SC",2010,"WKMA",1266,793,473,317,156
"SC",2011,"AFOGNAK",3052,2565,487,385,102
"SC",2011,"ALEUTIAN",5,0,5,0,5
"SC",2011,"BERING",0,0,0,0,0
"SC",2011,"BSAI",5,0,5,0,5
"SC",2011,"CHIGNIK",60,60,0,0,0
"SC",2011,"CI",3046,2570,476,174,302
"SE",2011,"CSEO",58843,46504,12339,4215,8124
"SC",2011,"EASTSIDE",1928,1853,75,39,36
"SE",2011,"EWYKT",2848,2363,485,111,374
"SE",2011,"EYKT",283,165,118,36,82
"SE",2011,"IBS",2565,2198,367,75,292
"SC",2011,"MAINLAND",99,98,1,1,0
"SC",2011,"NG",30322,24713,5609,3576,2033
"SC",2011,"NORTHEAST",6904,6611,293,140,153
"SE",2011,"NSEI",13281,8325,4956,1146,3810
"SE",2011,"NSEO",8950,6832,2118,831,1287
"SC",2011,"PWSI",11367,8192,3175,1443,1732
"SC",2011,"PWSO",15590,11330,4260,3189,1071
"SC",2011,"SAKPEN",0,0,0,0,0
"SC",2011,"SKMA",689,552,137,77,60
"SC",2011,"SOKO2SAP",749,612,137,77,60
"SC",2011,"SOUTHEAST",689,552,137,77,60
"SC",2011,"SOUTHWEST",0,0,0,0,0
"SE",2011,"SSEI",17328,9231,8097,2407,5690
"SE",2011,"SSEO",11926,8143,3783,1424,2359
"SC",2011,"WESTSIDE",1267,1019,248,162,86
"SC",2011,"WKMA",1366,1117,249,163,86
"SC",2012,"AFOGNAK",3025,2461,564,411,153
"SC",2012,"ALEUTIAN",13,13,0,0,0
"SC",2012,"BERING",0,0,0,0,0
"SC",2012,"BSAI",13,13,0,0,0
"SC",2012,"CHIGNIK",121,99,22,0,22
"SC",2012,"CI",4677,4109,568,201,367
"SE",2012,"CSEO",57675,43380,14295,4550,9745
"SC",2012,"EASTSIDE",3433,3210,223,76,147
"SE",2012,"EWYKT",3241,2727,514,147,367
"SE",2012,"EYKT",541,418,123,38,85
"SE",2012,"IBS",2700,2309,391,109,282
"SC",2012,"MAINLAND",0,0,0,0,0
"SC",2012,"NG",27771,22056,5715,3368,2347
"SC",2012,"NORTHEAST",6813,6257,556,205,351
"SE",2012,"NSEI",15243,9183,6060,1252,4808
"SE",2012,"NSEO",8600,6467,2133,737,1396
"SC",2012,"PWSI",13580,9313,4267,1727,2540
"SC",2012,"PWSO",16566,11401,5165,3484,1681
"SC",2012,"SAKPEN",0,0,0,0,0
"SC",2012,"SKMA",918,568,350,107,243
"SC",2012,"SOKO2SAP",1039,667,372,107,265
"SC",2012,"SOUTHEAST",918,568,350,107,243
"SC",2012,"SOUTHWEST",0,0,0,0,0
"SE",2012,"SSEI",20908,9031,11877,3147,8730
"SE",2012,"SSEO",14290,9606,4684,1749,2935
"SC",2012,"WESTSIDE",1747,1322,425,335,90
"SC",2012,"WKMA",1747,1322,425,335,90
"SC",2013,"AFOGNAK",2487,2014,473,382,91
"SC",2013,"ALEUTIAN",0,0,0,0,0
"SC",2013,"BERING",0,0,0,0,0
"SC",2013,"BSAI",0,0,0,0,0
"SC",2013,"CHIGNIK",69,19,50,0,50
"SC",2013,"CI",4808,4380,428,162,266
"SE",2013,"CSEO",60735,48283,12452,4216,8236
"SC",2013,"EASTSIDE",2207,2081,126,54,72
"SE",2013,"EWYKT",3884,3432,452,56,396
"SE",2013,"EYKT",616,514,102,22,80
"SE",2013,"IBS",3268,2918,350,34,316
"SC",2013,"MAINLAND",4,3,1,0,1
"SC",2013,"NG",30558,25257,5301,3428,1873
"SC",2013,"NORTHEAST",9965,9327,638,361,277
"SE",2013,"NSEI",14770,9583,5187,1159,4028
"SE",2013,"NSEO",6970,5295,1675,713,962
"SC",2013,"PWSI",14209,10875,3334,1384,1950
"SC",2013,"PWSO",19818,14223,5595,3409,2186
"SC",2013,"SAKPEN",0,0,0,0,0
"SC",2013,"SKMA",1035,868,167,113,54
"SC",2013,"SOKO2SAP",1104,887,217,113,104
"SC",2013,"SOUTHEAST",1035,868,167,113,54
"SC",2013,"SOUTHWEST",0,0,0,0,0
"SE",2013,"SSEI",24779,11207,13572,3164,10408
"SE",2013,"SSEO",15619,11144,4475,1811,2664
"SC",2013,"WESTSIDE",1979,1623,356,279,77
"SC",2013,"WKMA",1983,1626,357,279,78
"SC",2014,"AFOGNAK",2843,2263,580,434,146
"SC",2014,"ALEUTIAN",44,44,0,0,0
"SC",2014,"BERING",0,0,0,0,0
"SC",2014,"BSAI",44,44,0,0,0
"SC",2014,"CHIGNIK",62,56,6,0,6
"SC",2014,"CI",4731,4369,362,94,268
"SE",2014,"CSEO",73709,60201,13508,4240,9268
"SC",2014,"EASTSIDE",3551,3385,166,131,35
"SE",2014,"EWYKT",4695,4020,675,125,550
"SE",2014,"EYKT",517,424,93,30,63
"SE",2014,"IBS",4178,3596,582,95,487
"SC",2014,"MAINLAND",0,0,0,0,0
"SC",2014,"NG",37025,31936,5089,2911,2178
"SC",2014,"NORTHEAST",11896,10360,1536,392,1144
"SE",2014,"NSEI",19857,13571,6286,1206,5080
"SE",2014,"NSEO",8688,6428,2260,820,1440
"SC",2014,"PWSI",14913,10729,4184,1470,2714
"SC",2014,"PWSO",21309,15752,5557,3473,2084
"SC",2014,"SAKPEN",0,0,0,0,0
"SC",2014,"SKMA",653,557,96,49,47
"SC",2014,"SOKO2SAP",715,613,102,49,53
"SC",2014,"SOUTHEAST",653,557,96,49,47
"SC",2014,"SOUTHWEST",0,0,0,0,0
"SE",2014,"SSEI",25686,10668,15018,2923,12095
"SE",2014,"SSEO",18453,13323,5130,1522,3608
"SC",2014,"WESTSIDE",2396,1757,639,404,235
"SC",2014,"WKMA",2396,1757,639,404,235
"SC",2015,"AFOGNAK",3919,3289,630,421,209
"SC",2015,"ALEUTIAN",21,1,20,2,18
"SC",2015,"BERING",0,0,0,0,0
"SC",2015,"BSAI",21,1,20,2,18
"SC",2015,"CHIGNIK",43,3,40,0,40
"SC",2015,"CI",6321,5864,457,134,323
"SE",2015,"CSEO",80105,63217,16888,5352,11536
"SC",2015,"EASTSIDE",2787,2635,152,149,3
"SE",2015,"EWYKT",5729,4715,1014,215,799
"SE",2015,"EYKT",1353,1021,332,81,251
"SE",2015,"IBS",4376,3694,682,134,548
"SC",2015,"MAINLAND",9,9,0,0,0
"SC",2015,"NG",45883,39744,6139,3283,2856
"SC",2015,"NORTHEAST",12377,11799,578,394,184
"SE",2015,"NSEI",22095,13976,8119,1555,6564
"SE",2015,"NSEO",9156,6577,2579,911,1668
"SC",2015,"PWSI",20073,14853,5220,1742,3478
"SC",2015,"PWSO",24516,18386,6130,4084,2046
"SC",2015,"SAKPEN",0,0,0,0,0
"SC",2015,"SKMA",619,547,72,68,4
"SC",2015,"SOKO2SAP",662,550,112,68,44
"SC",2015,"SOUTHEAST",619,547,72,68,4
"SC",2015,"SOUTHWEST",0,0,0,0,0
"SE",2015,"SSEI",29160,11218,17942,4271,13671
"SE",2015,"SSEO",17669,12749,4920,1419,3501
"SC",2015,"WESTSIDE",2022,1655,367,285,82
"SC",2015,"WKMA",2031,1664,367,285,82
"SC",2016,"AFOGNAK",5287,4527,760,544,216
"SC",2016,"ALEUTIAN",1,0,1,1,0
"SC",2016,"BERING",0,0,0,0,0
"SC",2016,"BSAI",1,0,1,1,0
"SC",2016,"CHIGNIK",7,0,7,0,7
"SC",2016,"CI",10123,9344,779,185,594
"SE",2016,"CSEO",54908,42288,12620,5433,7187
"SC",2016,"EASTSIDE",3561,3392,169,99,70
"SE",2016,"EWYKT",7499,6237,1262,314,948
"SE",2016,"EYKT",1761,1385,376,123,253
"SE",2016,"IBS",5738,4852,886,191,695
"SC",2016,"MAINLAND",1,0,1,0,1
"SC",2016,"NG",56991,49153,7838,4064,3774
"SC",2016,"NORTHEAST",13580,12861,719,425,294
"SE",2016,"NSEI",25877,16646,9231,1642,7589
"SE",2016,"NSEO",5839,4347,1492,698,794
"SC",2016,"PWSI",28893,22198,6695,2486,4209
"SC",2016,"PWSO",29349,21660,7689,5233,2456
"SC",2016,"SAKPEN",0,0,0,0,0
"SC",2016,"SKMA",804,713,91,88,3
"SC",2016,"SOKO2SAP",811,713,98,88,10
"SC",2016,"SOUTHEAST",774,684,90,87,3
"SC",2016,"SOUTHWEST",30,29,1,1,0
"SE",2016,"SSEI",32540,13373,19167,4529,14638
"SE",2016,"SSEO",17707,13558,4149,1399,2750
"SC",2016,"WESTSIDE",3336,2644,692,588,104
"SC",2016,"WKMA",3337,2644,693,588,105
"SC",2017,"AFOGNAK",4756,4217,539,416,123
"SC",2017,"ALEUTIAN",1,0,1,0,1
"SC",2017,"BERING",6,6,0,0,0
"SC",2017,"BSAI",7,6,1,0,1
"SC",2017,"CHIGNIK",0,0,0,0,0
"SC",2017,"CI",8376,7453,923,391,532
"SE",2017,"CSEO",57388,46059,11329,4871,6458
"SC",2017,"EASTSIDE",3933,3877,56,37,19
"SE",2017,"EWYKT",6324,5527,797,230,567
"SE",2017,"EYKT",2287,2009,278,105,173
"SE",2017,"IBS",4037,3518,519,125,394
"SC",2017,"MAINLAND",2,1,1,1,0
"SC",2017,"NG",38626,32335,6291,3405,2886
"SC",2017,"NORTHEAST",6719,6478,241,176,65
"SE",2017,"NSEI",24305,19203,5102,1254,3848
"SE",2017,"NSEO",9211,7495,1716,756,960
"SC",2017,"PWSI",16300,11566,4734,1833,2901
"SC",2017,"PWSO",28647,20918,7729,5242,2487
"SC",2017,"SAKPEN",61,61,0,0,0
"SC",2017,"SKMA",666,607,59,51,8
"SC",2017,"SOKO2SAP",727,668,59,51,8
"SC",2017,"SOUTHEAST",666,607,59,51,8
"SC",2017,"SOUTHWEST",0,0,0,0,0
"SE",2017,"SSEI",30249,16481,13768,3574,10194
"SE",2017,"SSEO",20760,16390,4370,1924,2446
"SC",2017,"WESTSIDE",2897,2300,597,492,105
"SC",2017,"WKMA",2899,2301,598,493,105
"SC",2018,"AFOGNAK",5694,5092,602,449,153
"SC",2018,"ALEUTIAN",92,90,2,0,2
"SC",2018,"BERING",13,11,2,1,1
"SC",2018,"BSAI",105,101,4,1,3
"SC",2018,"CHIGNIK",10,10,0,0,0
"SC",2018,"CI",13009,11978,1031,376,655
"SE",2018,"CSEO",55460,44943,10517,4329,6188
"SC",2018,"EASTSIDE",3914,3690,224,102,122
"SE",2018,"EWYKT",8659,7682,977,286,691
"SE",2018,"EYKT",2998,2663,335,134,201
"SE",2018,"IBS",5661,5019,642,152,490
"SC",2018,"MAINLAND",3,3,0,0,0
"SC",2018,"NG",50115,41846,8269,4260,4009
"SC",2018,"NORTHEAST",8479,8163,316,209,107
"SE",2018,"NSEI",34673,28268,6405,1370,5035
"SE",2018,"NSEO",11024,9189,1835,858,977
"SC",2018,"PWSI",12107,8741,3366,1314,2052
"SC",2018,"PWSO",27142,21809,5333,3304,2029
"SC",2018,"SAKPEN",100,65,35,34,1
"SC",2018,"SKMA",671,599,72,71,1
"SC",2018,"SOKO2SAP",781,674,107,105,2
"SC",2018,"SOUTHEAST",652,580,72,71,1
"SC",2018,"SOUTHWEST",19,19,0,0,0
"SE",2018,"SSEI",42049,25419,16630,3678,12952
"SE",2018,"SSEO",26949,22414,4535,1795,2740
"SC",2018,"WESTSIDE",4288,3580,708,540,168
"SC",2018,"WKMA",4291,3583,708,540,168
"SC",2019,"AFOGNAK",6782,5762,1020,719,301
"SC",2019,"ALEUTIAN",91,91,0,0,0
"SC",2019,"BERING",0,0,0,0,0
"SC",2019,"BSAI",91,91,0,0,0
"SC",2019,"CHIGNIK",8,6,0,2,0
"SC",2019,"CI",16061,15076,985,445,540
"SE",2019,"CSEO",59842,51062,8780,3968,4812
"SC",2019,"EASTSIDE",5680,5564,116,110,6
"SE",2019,"EWYKT",7908,7169,739,154,585
"SE",2019,"EYKT",1469,1376,93,23,70
"SE",2019,"IBS",6439,5793,646,131,515
"SC",2019,"MAINLAND",0,0,0,0,0
"SC",2019,"NG",64565,55039,9526,5735,3791
"SC",2019,"NORTHEAST",9881,9446,435,277,158
"SE",2019,"NSEI",36293,30096,6197,1413,4784
"SE",2019,"NSEO",11553,9925,1628,769,859
"SC",2019,"PWSI",15083,11420,3663,1633,2030
"SC",2019,"PWSO",33682,26059,7623,5092,2531
"SC",2019,"SAKPEN",38,34,4,4,0
"SC",2019,"SKMA",716,588,128,120,8
"SC",2019,"SOKO2SAP",762,628,132,126,8
"SC",2019,"SOUTHEAST",700,576,124,117,7
"SC",2019,"SOUTHWEST",16,12,4,3,1
"SE",2019,"SSEI",35867,21016,14851,3091,11760
"SE",2019,"SSEO",22912,19342,3570,1727,1843
"SC",2019,"WESTSIDE",6954,5644,1310,1037,273
"SC",2019,"WKMA",6954,5644,1310,1037,273
"SC",2020,"AFOGNAK",5835,5004,831,605,226
"SC",2020,"ALEUTIAN",16,14,2,0,2
"SC",2020,"BERING",0,0,0,0,0
"SC",2020,"BSAI",16,14,2,0,2
"SC",2020,"CHIGNIK",15,14,1,1,0
"SC",2020,"CI",9784,9134,650,250,400
"SE",2020,"CSEO",24728,23904,824,9,815
"SC",2020,"EASTSIDE",1507,1436,71,46,25
"SE",2020,"EWYKT",4059,3983,76,0,76
"SE",2020,"EYKT",924,851,73,0,73
"SE",2020,"IBS",3135,3132,3,0,3
"SC",2020,"MAINLAND",2,0,2,2,0
"SC",2020,"NG",43363,37152,6211,3649,2562
"SC",2020,"NORTHEAST",4479,4183,296,227,69
"SE",2020,"NSEI",17585,17302,283,21,262
"SE",2020,"NSEO",3314,3142,172,3,169
"SC",2020,"PWSI",9001,6714,2287,925,1362
"SC",2020,"PWSO",29279,23828,5450,3259,2191
"SC",2020,"SAKPEN",0,0,0,0,0
"SC",2020,"SKMA",302,255,47,46,1
"SC",2020,"SOKO2SAP",317,269,48,47,1
"SC",2020,"SOUTHEAST",290,243,47,46,1
"SC",2020,"SOUTHWEST",12,12,0,0,0
"SE",2020,"SSEI",11107,10782,325,8,317
"SE",2020,"SSEO",12619,12449,170,1,169
"SC",2020,"WESTSIDE",4033,3456,577,453,124
"SC",2020,"WKMA",4035,3456,579,455,124
"SC",2021,"AFOGNAK",9007,7930,1077,817,260
"SC",2021,"ALEUTIAN",98,63,35,0,35
"SC",2021,"BERING",0,0,0,0,0
"SC",2021,"BSAI",98,63,35,0,35
"SC",2021,"CHIGNIK",13,13,0,0,0
"SC",2021,"CI",14326,13225,1101,396,705
"SE",2021,"CSEO",56521,53700,2821,10,2811
"SC",2021,"EASTSIDE",2885,2698,187,165,22
"SE",2021,"EWYKT",7343,7225,118,0,118
"SE",2021,"EYKT",827,770,57,0,57
"SE",2021,"IBS",6516,6455,61,0,61
"SC",2021,"MAINLAND",119,102,17,17,0
"SC",2021,"NG",83097,73272,9825,5467,4358
"SC",2021,"NORTHEAST",9680,8979,701,421,280
"SE",2021,"NSEI",33151,31211,1940,4,1936
"SE",2021,"NSEO",9732,9094,638,0,638
"SC",2021,"PWSI",16848,13201,3647,1380,2267
"SC",2021,"PWSO",38638,32675,5963,3753,2210
"SC",2021,"SAKPEN",0,0,0,0,0
"SC",2021,"SKMA",1622,1428,194,162,32
"SC",2021,"SOKO2SAP",1635,1441,194,162,32
"SC",2021,"SOUTHEAST",1622,1428,194,162,32
"SC",2021,"SOUTHWEST",0,0,0,0,0
"SE",2021,"SSEI",28388,27134,1254,6,1248
"SE",2021,"SSEO",29399,29038,361,1,360
"SC",2021,"WESTSIDE",7805,6791,1014,737,277
"SC",2021,"WKMA",7924,6893,1031,754,277
"SC",2022,"AFOGNAK",9245,8314,931,672,259
"SC",2022,"ALEUTIAN",12,12,0,0,0
"SC",2022,"CHIGNIK",0,0,0,0,0
"SC",2022,"CI",13588,12464,1124,314,810
"SE",2022,"CSEO",67729,64331,3398,32,3366
"SC",2022,"EASTSIDE",1830,1703,127,99,28
"SE",2022,"EWYKT",6780,6589,191,5,186
"SE",2022,"EYKT",1169,1069,100,0,100
"SE",2022,"IBS",5611,5520,91,5,86
"SC",2022,"MAINLAND",164,135,29,27,2
"SC",2022,"NG",86557,76808,9749,4808,4941
"SC",2022,"NORTHEAST",10988,10366,623,362,261
"SE",2022,"NSEI",34168,31320,2848,3,2845
"SE",2022,"NSEO",10558,9674,884,0,884
"SC",2022,"PWSI",21689,17943,3746,1380,2366
"SC",2022,"PWSO",36677,31685,4992,2914,2078
"SC",2022,"SAKPEN",16,16,0,0,0
"SC",2022,"SKMA",1321,1112,209,190,19
"SC",2022,"SOUTHEAST",1321,1112,209,190,19
"SC",2022,"SOUTHWEST",0,0,0,0,0
"SE",2022,"SSEI",33837,29854,3983,34,3949
"SE",2022,"SSEO",38456,37538,918,1,917
"SC",2022,"WESTSIDE",10983,9590,1393,1044,349
"SC",2022,"WKMA",11147,9725,1422,1071,351
"SC",2023,"AFOGNAK",11425,10252,1172,800,372
"SC",2023,"ALEUTIAN",74,0,74,38,36
"SC",2023,"CHIGNIK",0,0,0,0,0
"SC",2023,"CI",11260,9879,1380,438,942
"SE",2023,"CSEO",51033,48472,2561,3,2558
"SC",2023,"EASTSIDE",2230,2147,83,74,9
"SE",2023,"EWYKT",6906,6785,121,1,120
"SE",2023,"EYKT",1546,1483,63,0,63
"SE",2023,"IBS",5360,5302,58,1,57
"SC",2023,"MAINLAND",222,177,45,24,21
"SC",2023,"NG",64944,56421,8524,4509,4015
"SC",2023,"NORTHEAST",10167,9726,441,255,186
"SE",2023,"NSEI",31783,29468,2315,0,2315
"SE",2023,"NSEO",14337,13719,618,5,613
"SC",2023,"PWSI",17019,13806,3213,839,2374
"SC",2023,"PWSO",25617,21740,3877,2160,1717
"SC",2023,"SKMA",1383,1251,132,122,10
"SC",2023,"SOUTHEAST",1383,1251,132,122,10
"SC",2023,"SOUTHWEST",0,0,0,0,0
"SE",2023,"SSEI",44574,40360,4214,8,4206
"SE",2023,"SSEO",41560,40948,612,4,608
"SC",2023,"WESTSIDE",9809,8461,1348,957,391
"SC",2023,"WKMA",10031,8638,1393,981,412
